level8
Blan
WWWWWWWWWWWWWWWWWWWWWWWWWWWWWWWWWW
WWWWWSSSSWWSWWWWWWWSWWWSWWWWSWWWWW
WWWWWSWWWSWSWWWWWWSWSWWSSWWWSWWWWW
WWWWWSWWWSWSWWWWWWSWSWWSWSWWSWWWWW
WWWWWSSSSWWSWWWWWSWWWSWSWSWWSWWWWW
WWWWWSWWWSWSWWWWWSSSSSWSWWSWSWWWWW
WWWWWSWWWSWSWWWWWSWWWSWSWWWSSWWWWW
WWWWWSSSSWWSSSSSWSWWWSWSWWWWSWWWWW
WWWWWWWWWWWWWWWWWWWWWWWWWWWWWWWWWW
WWWWWWWWWWWWWWWWWWWWWWWWWWWWWWWWWW
WWWWWWSSPSSSSCCCSSSSSSCCCSSSWWWWWW
WWWWWWSWWWWWWWWWSWWWWWWWWWWSWWWWWW
WWWWWWSWWWWWWWWWSWWWWWWWWWWSWWWWWW
WWWWWWSWWWWSWWWWSWWWWWSWWWWSWWWWWW
WWWWWWSWWWWWWWWWSWWWWWWWWWWSWWWWWW
WWWWWWSWWWWWWSSSSSSSWWWWWWWSWWWWWW
WWWWWWSWWWWWWWWWSWWWWWWWWWWSWWWWWW
WWWWWWSSSSSSSBSSSSBSSSSSSSSSWWWWWW
WWWWWWWWWWWWWWWWWWWWWWWWWWWWWWWWWW
