level9
Dev-2.0
WWWWWWWWWWWWWWWWWWWWWWWWWWWWWWWW
WSSCSSSSSSSSSCPSSSSSSCSSSSSSSCSW
WSWSWSWSWSWWSWWWWWWWWWWWWWWWWWSW
WSWSWSWSWSWWSSCSSSSSSSCSSSSCSWSW
WSWSWCWCWSWWSWSWSWSWSWSWSWSWSWSW
WSWSWSWSWSSSSSCSSSSSSSSCSSSSSSCW
WSWSWSWSWSWWSWSWWWWWWWWWWWWWWWSW
WCWCWSWSWSWWSWSWSWCSSSSSSSSWSSSW
WSWSWSWCWSWWSWSWSWSWWWWWWWWWSWSW
WSSSSSSSSSSWSWSWCWSWSSSSCSSSSWSW
WSWWWWWWWWSWSWSWSWSWWWWWWWWWSWSW
WCSSSSSSSSCWSWSWSWSWSSSSSSSSCWBW
WSWWWWWWSWSWSWSWSWSWWWWWWWWWWWSW
WSSSSSCWSWSWSWSWSWSWSSSCSSSSSSCW
WSWSWWSWSSCWSWSWSWSWWWWWWWWWWWWW
WSWSWWSWSWSWSWSSSSSSSSSSSSSSSSSW
WSWSWWSWSWSWSWWWWWWWWWWWWWWWWWSW
WSWSSSSSCSSSSSSSSSSCSSSSSSSSSSSW
WSWSWSWSWSWSWSWSWSWSWSWSWSWSWWSW
WSWSCCCCCCCCCCCCCCCCCCCCCCCCCWSW
WCWWWWWWWWWWWWWWSWWWWWWWWWWWWWSW
WBSSSSCSSSSSSSSSSSSSSCSSSSCSSSSW
WWWWWWWWWWWWWWWWWWWWWWWWWWWWWWWW
