level2
Rychla Vyhra
WWWWWWWWWWWWWWWWWWWWWWWWWWWWWWW
WSSSSSSSSSSSSSSSSSSSSSSCSSCSSCW
WPWWWWWWWWWWWWWWWWWWWWWWWWWWWWW
WSSSSSSSSSSSSSSSSSSSSSSSSSSSSSW
WWWWWWWWWWWWWWWWWWWWWWWWWWWWWSW
WBSSSSSSSSSSSSSSSSSSSSSSSSSSSSW
WWWWWWWWWWWWWWWWWWWWWWWWWWWWWWW
