level3
Basic Training
WWWWWWWWWWWWWWWWWWW
WWWWWWCWWWWCWWWWPWW
WBSSCSSSSCSSSWSSSCW
WSWWWWSWWWWSWWWWSWW
WCSCWSSSSSSCSSSSSWW
WSWWWWSWWWWSWWWWSWW
WSSSCSSSSCSSSSCSSWW
WSWWWWSWWWWSWWWWCWW
WSCSSSCSWSSSSCSSSWW
WSWWWWSWWWWSWWWWCWW
WCSSSSSSCSSSSSSCSWW
WSWWWWSWWWWWWWWWSWW
WSSSCSSSSCSSSWSSSWW
WSWWWWSWWWWSWWWWSWW
WCSSSSSCWCSSSSSSCWW
WWWWWWWWWWWWWWWWWWW
