level4
Twisty
WWWWWWWWWWWWWWWWWWWWWWWWWWWWWWWW
WWWSSBSSSSSCSSSCSPSSSSCSSSWWWWWW
WWSSWCWWWWWWWWWWWCWWWWWWWSSSSWWW
WCCWWSWWWWWWWWWWWSWWWWWWWWWWSCSW
WSWWWSCCSSSSCSSSSCSSSSCWWWWWWWSW
WSCSWSWWWWWWSSWWWWWWWWSWWWWWWWCW
WSWSWSWWWWWSCWWWWWSSCSSWWWWWWSSW
WSWSWSWWWWWWSSWWWSCWWWSSWWWWSSWW
WCWSSSWWWWWWWSSSCSWWWWWCSWWSCWWW
WSWWWWWWWWWWWWWWWWWWWWWWSSCSWWWW
WSSSSSCSSSSWWWWWWSSCWWWWSWSWWWWW
WWCWWWWWWWSWWWWWSSWSSWWSSWCSSWWW
WCSSCSSSSSSCWWWSSWWWSSSSWWWWSSWW
WSWSWWWWWWSSSCSSCSWWWWWWWWWWWCWW
WSWSSWWWWWWCWWWWWSSSSSCSSSSSSSWW
WSWWCSSSSWWWWWWWWWWSSWWWWWWSWWWW
WSSWWWWWSSSWWWWWWWWWCSSSCSSSSSSW
WWSSWWWWWWSWWWWWWWWSCWWWWCWWWWSW
WWWCSCSBSCSSCSSCSSSCWWWWWSSCSBCW
WWWWWWWWWWWWWWWWWWWWWWWWWWWWWWWW
