level7
FreeSpace
WWWWWWWWWWWWWWWWWWWWWWWWWWWW
WBSSSSSCSSSSSSSSSSSCSSSSCSSW
WSSSSWWWWWWWWWWWWWWWWSSSSSSW
WSCSSSSSSSSSCSSCSSSSSSSSSSSW
WSSSSSSWWWWSSSSSSSSSSCCCCSSW
WSSSCSSSSSSSSSSSSSSSSSSSSSSW
WSSSSSSSSSWWWWWWWWWWSSSSSSSW
WSSSSSSSSSSSCSSSSSCSSSSSSSSW
WSCSSWWWWSSSSSPSSWSSSSSSCSSW
WSSSSSSSSCSSWWWSSSSSSWSSCSSW
WSSSSSWSSSSSSSSSSSSSSSSSSSSW
WSSSCSSSSSCSSSSSCCCSSSSSSSSW
WSSSSSSSSWWWWWWSSSCSSSSWWWWW
WSSSSSCSSSSSSSSSSSCSSSSSSSSW
WSCSSSSSCSSSSSSSSSSSSSCSSSBW
WWWWWWWWWWWWWWWWWWWWWWWWWWWW
